R 800 600
NO ./textures/gold.xpm
SO ./textures/Bricks.xpm
WE ./textures/Bark.xpm
EA ./textures/Glass.xpm
S ./textures/sprite1.xpm
F 255,156,119
C 119,222,255

       1111111111111111111111111111111
       1000000000110000000000000000001
       1011000001110000002000000000111
       10010000000000000000000000001
111111111011000001110000000000001111
100000000011000001110000000000001
111101111111110111000000010000001
111101111111110111010000000200001
110000001101010111000002002000001
100020000000000011001000020001001
100000000000000000000000000000001
110000011101010111002000000000001
11110111 1110101 1000000N00000001
11111111 1111111 1111111111111111
